NO ./assets/_exit.xpm
EA ./assets/_oseano.xpm
SO ./assets/_item.xpm
WE ./assets/_sand.xpm
F 0,100,0
C 20,0,200
1111111111111111111111111
1000000000110 W0000000001
1011000001110000000000001
1001000000000000000000001
1111111110110000011100001
10000000001100000111011111111
11110111111111011100000010001
11110111111111011101010010001
11000000110101011100000010001
10000000000100000110000001001
10000000000000001101010010001
1100000111010101111101111000111
11110111 1110101 101111010001
11111111 1111111 111111111111