NO ./assets/_exit.xpm
EA ./assets/_oseano.xpm
SO ./assets/_item.xpm
WE ./assets/_sand.xpm
F 0,100,0
C 20,0,200
111111111111
10000000N001
100000000001
111111111111